1111111111
1000000111
1101010002
1101011111
1100011101
3001100001
1101101111
1101100011
1000001001
1111111111