1111111111
3001111111
1101011111
1101011102
1100011101
1101100001
1101101111
1101100011
1000001001
1111111111